* . # . . f . # . .
* . # . . . . # . .
* . . # . . . # . .
. . . # . . . . . .
. # # . . . . . . .
. . . . . . # . . .
. . . # . . # . # .
. # . . . . # . . .
. # . . . . . . . .
. . . # . . . # . .